SAMPLE INPUT:
7
#####################
###O11###...###M13###
###......O22......###
###...######M22######
###BBB###M31###M11###
###...O32...M33O31###
#####################
SAMPLE OUTPUT:
8
